1111111111
1010100001
10P0000001
1000100001
1111111111