1111111111
1010100001
101P001101
1010100101
1010110101
1000100001
1111111111