1111111111
1010100001
1010001001
1010100101
1010100101
1000P10001
1111111111