1111111111
10101000P1
1010001001
1010100001
1010101001
1000010101
1111111111