1111111111
1P10100001
1010001101
1010100101
1010110101
1000100001
1111111111