1111111111
1P00100001
1000001101
1010000001
1010100101
1000100001
1111111111