1111111111
1010100001
1010001001
1010100001
1010101001
1000P10101
1111111111