1111111111111111111
1P10000001000000001
1010101001010010001
1010101001111100101
1010001000000011001
1010101000000011001
1010101001110111001
1000101000000000001
1111101111111110111
1111101111111110111
1P10000001000000001
1010101001010010001
1010101001111100101
1010001000000011001
1010101000000011001
1010101001110111001
1000101000000000001
1111111111111111111