NO ./img/big.png
WE ./img/trump.png
SO ./img/nezuko.png
EA ./img/zoe.png
F 220,100,0
C 225,30,0

11111111111111111111111
1E0000000000000000000001
11111111111111111111111



















































