NO ./img/big.png
SO ./img/big.png
WE ./img/big.png
EA 

F 29,100,0
C 225,30,0

111111111
100000N01
111111111