NO ./img/big.png
SO ./img/big.png
WE ./img/big.png
EA ./img/big.png
111111N11
100000001
111111111

F 220,100,0
C 225,30,0
