NO ./img/big.png
WE ./img/big.png
SO ./img/big.png
EA ./img/zoe.png
F 220,100,0
C 225,30,0

111111111111111111111111111111111111111111
1000000000000000000001111111111111000001111
1011111111111000000000000011010000000000001
1010000010111111111000111111011101111111111
1000111000000000000000000000000000000000001
1011111111111100011111111100011110111111101
1011111111111100011000001100011110111111101
1000000000000000000000000000000000000000001
1011111101111100011100001100011110111111111
1011111101111101011110111111111110111111111
1000000000000000000000000000000000000000001
1000000000000000000000000000000000000000001
101111110111110101000000001111111110111111111
101111110111110100000000001111110111111111
101111110111110000000000000011110111111111
1000000000000000000000000000000000000000001
1011111111111100000000000000011110111111101
101111110111110101000000001111111110111111111
101111110111110100000000001111110111111111
101111110111110000000000000011110111111111
1000000000000000000000000000000000000000001
1011111111111100000000000000011110111111101
101111110111110101000000001111111110111111111
101111110111110100000000001111110111111111
101111110111110000000000000011110111111111
1000000000000000000000000000000000000000001
1011111111111100000000000000011110111111101
101111110111110101000000001111111110111111111
101111110111110100000000001111110111111111
101111110111110000000000000011110111111111
1000000000000000000000000000000000000000001
1011111111111100000000000000011110111111101
101111110111110101000000001111111110111111111
101111110111110100000000001111110111111111
101111110111110000000000000011110111111111
1000000000000000000000000000000000000000001
1011111111111100000000000000011110111111101
101111110111110101000000001111111110111111111
101111110111110100000000001111110111111111
101111110111110000000000000011110111111111
1000000000000000000000000000000000000000001
1011111111111100000000000000011110111111101
101111110111110101000000001111111110111111111
101111110111110100000000001111110111111111
101111110111110000000000000011110111111111
1000000000000000000000000000000000000000001
1011111111111100000000000000011110111111101
101111110111110101000000001111111110111111111
101111110111110100000000001111110111111111
101111110111110000000000000011110111111111
1000000000000000000000000000000000000000001
1011111111111100000000000000011110111111101
101111110111110101000000001111111110111111111
101111110111110100000000001111110111111111
101111110111110000000000000011110111111111
1000000000000000000000000000000000000000001
1011111111111100000000000000011110111111101
101111110111110101000000001111111110111111111
101111110111110100000000001111110111111111
101111110111110000000000000011110111111111
1000000000000000000000000000000000000000001
1011111111111100000000000000011110111111101
101111110111110101000000001111111110111111111
101111110111110100000000001111110111111111
101111110111110000000000000011110111111111
1000000000000000000000000000000000000000001
1011111111111100000000000000011110111111101
101111110111110101000000001111111110111111111
101111110111110100000000001111110111111111
101111110111110000000000000011110111111111
1000000000000000000000000000000000000000001
1011111111111100000000000000011110111111101
101111110111110101000000001111111110111111111
101111110111110100000000001111110111111111
101111110111110000000000000011110111111111
1000000000000000000000000000000000000000001
1011111111111100000000000000011110111111101
101111110111110101000000001111111110111111111
101111110111110100000000001111110111111111
101111110111110000000000000011110111111111
1000000000000000000000000000000000000000001
1011111111111100000000000000011110111111101
1011111111111100011100011100011110111111101
100011100000000000000N000000000000000000001
1111111111111111111111111111111111111111111















































