NO ./img/big.png
WE ./img/big.png
SO ./img/big.png
EA ./img/zoe.png


F 220,100,0
C 225,30,0

1111111111111111111111111111111111111111111111111111111111111111111111111111111111111111111111
1010101000000000000000000000000000000000000000000000000000000000000000000000000000000000000001
1000101011111111111111111111111111111111111111111111111111111111111111111111111111111111111101
1010101010000000000000000000000000000000000000000000000000000000000000000000000000000000000001
1010001010111111111111111111111111111111111111111111111111111111111111111111111111111111111101
1011101000100000000000000000000000000000000000000000000000000000000000000000000000000000000001
1010101010101111111111111111111111111111111111111111111111111111111111111111111111111111111101
1010000000100000000000000000000000000000000000000000000000000000000000000000000000000000000001
1011111101111111111111111111111111111111111111111111111111111111111111111111111111111111111101
1010000000000000000000000000000000000000000000000000000000000000000000000000000000000000000001
1011111111111111111111111111111111111111111111111111111111111111111111111111111111111111111101
1010000000000000000000000000000000000000000000000000000000000000000000000000000000000000000001
1011111111111111111111111111111111111111111111111111111111111111111111111111111111111111111101
1010000000000000000000000000000000000000000000000000000000000000000000000000000000000000000001
1011111111111111111111111111111111111111111111111111111111111111111111111111111111111111111101
1010000000000000000000000000000000000000000000000000000000000000000000000000000000000000000001
1011111111111111111111111111111111111111111111111111111111111111111111111111111111111111111101
1010000000000000000000000000000000000000000000000000000000000000000000000000000000000000000001
1011111111111111111111111111111111111111111111111111111111111111111111111111111111111111111101
1010000000000000000000000000000000000000000000000000000000000000000000000000000000000000000001
1N11111111111111111111111111111111111111111111111111111111111111111111111111111111111111111101
1010000000000000000000000000000000000000000000000000000000000000000000000000000000000000000001
1011111111111111111111111111111111111111111111111111111111111111111111111111111111111111111101
1010000000000000000000000000000000000000000000000000000000000000000000000000000000000000000001
1011111111111111111111111111111111111111111111111111111111111111111111111111111111111111111101
1010000000000000000000000000000000000000000000000000000000000000000000000000000000000000000001
1011111111111111111111111111111111111111111111111111111111111111111111111111111111111111111101
1010000000000000000000000000000000000000000000000000000000000000000000000000000000000000000001
1011111111111111111111111111111111111111111111111111111111111111111111111111111111111111111101
1010000000000000000000000000000000000000000000000000000000000000000000000000000000000000000001
1011111111111111111111111111111111111111111111111111111111111111111111111111111111111111111101
1010000000000000000000000000000000000000000000000000000000000000000000000000000000000000000001
1011111111111111111111111111111111111111111111111111111111111111111111111111111111111111111101
1010000000000000000000000000000000000000000000000000000000000000000000000000000000000000000001
1011111111111111111111111111111111111111111111111111111111111111111111111111111111111111111101
1010000000000000000000000000000000000000000000000000000000000000000000000000000000000000000001
1011111111111111111111111111111111111111111111111111111111111111111111111111111111111111111101
1010000000000000000000000000000000000000000000000000000000000000000000000000000000000000000001
1011111111111111111111111111111111111111111111111111111111111111111111111111111111111111111101
1010000000000000000000000000000000000000000000000000000000000000000000000000000000000000000001
1011111111111111111111111111111111111111111111111111111111111111111111111111111111111111111101
1010000000000000000000000000000000000000000000000000000000000000000000000000000000000000000001
1011111111111111111111111111111111111111111111111111111111111111111111111111111111111111111101
1000101010000000000000000000000000000000000000000000000000000000000000000000000000000000000001
1010101001111111111111111111111111111111111111111111111111111111111111111111111111111111111101
1010101000000000000000000000000000000000000000000000000000000000000000000000000000000000000001
1011111111111111111111111111111111111111111111111111111111111111111111111111111111111111111101
1010000000000000000000000000000000000000000000000000000000000000000000000000000000000000000001
1011111111111111111111111111111111111111111111111111111111111111111111111111111111111111111101
1000000000000000000000000000000000000000000000000000000000000000000000000000000000000000000001
1111111111111111111111111111111111111111111111111111111111111111111111111111111111111111111111