F 0,0,0
EA ./img/sm64/1.png
C 100,100,200
SO ./img/sm64/2.png
NO ./img/sm64/3.png
MU ./audio/music/smrpg.mp3



WE ./img/sm64/4.png

     111
    10001
   1000001
  100000001
 10000100001
100000100000111111111111
100001010000000000000001
10N001111111111111100001
122221            100001
100001            100101
1000011111111111111C11C1
100000100000000000300001
 1000011111111111100001
  10000111111111100001
   100001111111000001
    1000001110000001
     10000010000001
      100000000001
       1000000001
        10100001
         110001
          1111