F 0,0,0
EA ./img/sm64/1.png
C 100,100,200
SO ./img/sm64/2.png
NO ./img/sm64/3.png
MU ./audio/music/smrpg.mp3



WE ./img/sm64/4.png


1111111111111
1000000000001
1000000000001
1000001000001
1000000000001
10000000000N1
1111111111111