                        NO                      ./img/big.png
WE                                                           ./img/big.png
                     C     0,        0,         0
                                 SO ./img/big.png                           
EA ./img/big.png












F 255,0,255


       1
      1S1
     10001
    1000001
   111101111
      101111111111
      100000000001
      111111111101            111 
               101111111111111001
              100000000000000001
11111 1111111111111111111111111