NO ./img/big.png
WE ./img/nezuko.png
SO ./img/big.png
EA ./img/zoe.png
F 0,0,0
C 0,30,0

11111111111
1N100010001
10101010101
10101010101
10101010101
10101010101
10101010101
10101010101
10101010101
10101010101
10101010101
10101010101
10101010101
10101010101
10101010101
10101010101
10101010101
10001000101
11111111111