NO ./img/big.png
WE ./img/big.png
SO ./img/big.png
EA ./img/zoe.png
F 220,100,0
C 225,30,0


1111111111111111111111111111111111111111111111111111111111111111111111111111111111111111111111111111
11000011111111111111111111111111111111111
1111111


111
101
1N11111111111111111111111111111111111111111111111111111111111111111111111111111111111111111111111111
1111111111111111111111111111111111111111111111111111111111111111111111111111111111111111111111111111