NO ./img/4.png
WE ./img/mac.png
SO ./img/mac.png
EA ./img/mac.png
F 0,0,0
C 0,30,0

111111111111111111111111111111111111111111111111111111
1N1000100011111111111111111111111111111111111111111111
101010101011111111111111111111111111111111111111111111
101010101011111111111111111111111111111111111111111111
101010101011111111111111111111111111111111111111111111
101010101011111111111111111111111111111111111111111111
101010101011111111111111111111111111111111111111111111
101010101011111111111111111111111111111111111111111111
101010101011111111111111111111111111111111111111111111
101010101011111111111111111111111111111111111111111111
101010101011111111111111111111111111111111111111111111
101010101011111111111111111111111111111111111111111111
101010101011111111111111111111111111111111111111111111
101010101011111111111111111111111111111111111111111111
101010101011111111111111111111111111111111111111111111
101010101011111111111111111111111111111111111111111111
101010101011111111111111111111111111111111111111111111
100010001011111111111111111111111111111111111111111111
111111111111111111111111111111111111111111111111111111