NO ./img/big.png
WE ./img/big.png
SO ./img/big.png
EA ./img/zoe.png
F 220,100,0
C 225,30,0

111111111
1000000001
1N00000001111111111111111111111111111111111111111111111111111111111111111111111111111111111111111111
1111111111111111111111111111111111111111111111111111111111111111111111111111111111111111111111111111