NO ./img/big.png
WE ./img/trump.png
SO ./img/big.png
EA ./img/zoe.png
F 0,0,0
C 0,30,0

1111111111
10000N0001
1011011011
1000000001
1000000001
1000000001
1000000001
1000000001
1000000001
1111001101
1100000001
1111111111
