NO ./img/big.png
WE ./img/mac.png
SO ./img/mac.png
EA ./img/mac.png
F 0,0,0
C 0,30,0

11111111111111111111111111111111111111111111111111
10000000000000000000000000000000000000000000000001
10111111111111111111111111111111111111111111111001
10100000000000000000000000000000000000000000000001
10101111111111111111111111111111111111111111111001
10101000000000000000000000000000000000000000000001
10101011111111111111111111111111111111111111111001
10101000000000000000000000000000000000000000000001
10101011111111111111111111111111111111111111111001
10101000000000000000000000000000000000000000000001
10101011111111111111111111111111111111111111111001
10101000000000000000000000000000000000000000000001
10101011111111111111111111111111111111111111111001
10101000000000000000000000000000000000000000000001
10101011111111111111111111111111111111111111111001
10101000000000000000000000000000000000000000000001
10101011111111111111111111111111111111111111111001
10101000000000000000000000000000000000000000000001
10101011111111111111111111111111111111111111111001
10101000000000000000000000000000000000000000000001
10101011111111111111111111111111111111111111111001
10101000000000000000000000000000000000000000000001
10101011111111111111111111111111111111111111111001
10101000000000000000000000000000000000000000000001
10101011111111111111111111111111111111111111111001
10101000000000000000000000000000000000000000000001
10101011111111111111111111111111111111111111111001
10101000000000000000000000000000000000000000000001
10101011111111111111111111111111111111111111111001
10101000000000000000000000000000000000000000000001
10101011111111111111111111111111111111111111111001
10101000000000000000000000000000000000000000000001
101010111111111111111111111111111111111111111110S1
11111111111111111111111111111111111111111111111111