NO ./img/big.png
WE ./img/zoe.png
SO ./img/big.png
EA ./img/zoe.png
F 220,100,0
C 225,30,0

11111
1W001
10001
11111