NO ./img/optic/1.png
WE ./img/optic/2.png
SO ./img/optic/3.png
EA ./img/optic/4.png
F 0,0,0
C 0,30,0

1111111111111111111111111111111111111111111111111111
1E00000000000000000000000000000000000000000000000001
1011000000000000000000000000000000000000000000000101
1010001010001010101000000010100000000000010100010101
1000001010000101000000001010100000101010100101010001
1010001010100001010100101010100100000000100010101001
1010100010000101000010100010100010100010101000101001
1000101010100001010001010100010100010100100001010001
1010000010101010100000101010000001010010100010100001
1101010101000001000010100001010001010001010010100011
1000100000100010000100001010100000101010100000101001
1010100010101010101010100010100010000101000001010101
1010000010000101010101000010100100101010100000000101
1010001111010100101010100101000101010101010101010101
1000101010101010001010101010100000101010100010101001
1010000010101010100001010010100010101010000101010101
1010101010101000000000000001010100000010100101010001
1000100000101010101010101010100000101010100101010101
1010101010000101010100010101000100000101000101010001
1010000010111010111010101010100010101010101010101101
1010101010100101010100010000000000000000101000101001
1000100010101000001010101010101010101010101010101101
1010101010000010101000101000010100010100010100010001
1010000010111010101010101010000000101010101010101101
1010101010010101010101000000101010101010100010100001
1000000000000000000010101010101010101010101010101101
1010101010101010100010101010101010100010101000010001
1010001000001010101010000000101010000010101010101101
1010101111111010101010101010101010100010101010101101
1010101010101010101010101010100010100010101000101101
1111111111111111111111111111111111111111111111111111