F 0,0,0
EA ./img/optic/1.png
C 100,0,100
SO ./img/optic/2.png
NO ./img/optic/3.png



WE ./img/optic/4.png


  11   11
 1001 1001
10000100001
10000000001
10000000001
 100000001
  1000001                11111111111111
   10001                 100000000000001
    101                  100111111111001
    101                  1001       1001
    101      1111111111111001       1001111
    101      1000000000000001       100000W1
    101      1011111111111001       1001111
11110001111  101         1001       1001
1000000000111001         100111111110001
1000000000000001         100000000000001
1111111111111111         11111111111111