NO ./img/sm64/1.png
WE ./img/sm64/2.png
SO ./img/sm64/3.png
EA ./img/sm64/4.png
MU ./audio/music/smrpg.mp3

F 0,0,0
C 0,200,200


11111111111111111111111111111
1S200000000000000000000000001
10111111111111111111111111101
10001                 1000101
10001                 1010101
10001                 1010101
100011111             1010101
100000001             1010101
100000001             1010101
100000001             1010101
100000001             1010101
100000001             1010101
100000001             1010101
10001111111111111111111010101
10003000000000C00000003030301
10001111111111111111111010101
10001                 1010101
10001                 1010101
10001                 1010101
10001                 1010101
10001111111111111111111010101
10000000000000000000000010101
10000000000000000000000010101
1111111111111111111111111C101
                        10001
                        1111