NO ./img/sm64/1.png
WE ./img/sm64/2.png
SO ./img/sm64/3.png
EA ./img/sm64/4.png
MU ./audio/music/smrpg.mp3

F 0,0,0
C 0,200,200

11111111111111111111111111111111111111111111111111111111111111111111111111111111
1000000S000000000200000000000000000000000000000000000000000000000000000000000001
10000000000000000111111111111111111111111111111111111111111111111113311111113111
10001000010000000110000000000000000000011000000000000000001100000010010010010101
1000000000000100011000011111000000000000C000010000000000001100000010010010010101
10001000000000000110000000001111111113311000100000100000001100000010010010010101
10000000000000000110111100000000000000011000000001000000001100000010010010010101
10010000000001000110000000000011111000011001000100000000001100000010010010010101
10000000100000000110000100000001000000011000001000100100001100000010010010010101
10000000000100000110011100000000001000011001000000010000001100000010010010010101
10000000000001000110001111100001000000011001000010000000101100000010010010010101
10000100000000000110000000011100001100011000100000001000001100000010010010010101
10000000010000000110000001011000010000011000001000000010001100000010010010010101
10000000000010000111111000000000000100011001000110000100001100000010010010010101
10001000000000000110010000100100000000011001000001000001001100000010010010010101
10000000100000000110100100100001000010011000000010000001001100000010010010010101
10000000000000000110010000010000001000011000001000000100001100000010010010010101
10010000000000100110001000000100010000011000001000100111001100000010010010010101
10000010000000000110000100000000000100011131110001001000001100000010010010010101
10000000000000000110001001000010001000011100010001000100001100000010010010010101
10000000000000000110001000000100000100011000000100001001001100000010010010010101
10000010000010000110000011000010000100011000000000000000001100000010010010010101
10000000000000000110100000001000010000011131100011100000001100000010010010010101
10000010000000000110000100000000100010011001111110000000001100000010010010010101
10000000000010000110000000000010100000011000001111111000001100000010010010010101
10000000000000000111000110000000111000011000000000000000001100000010010010010101
10100010000000000110000001010000000100011000000000011111111100000010010010010101
10000000000100000110000000000001000333311131000000000000001100000010010010010101
10000001000000000110010010010000000000011000000111111111111100000010010010010101
10000000000000000110001000000000000100011000000000000000001100000010010010010101
10000000000000000110000000111001000000011131111111111000001100000010010010010101
10000000000000000110000001000000000100011000000000010000001100000010010010010101
10000010000000000110010000101000000000011000010000000001001100000010010010010101
10000000000010000111100000100000110010011131000001100010001100000010010010010101
10000000000000000110000010000000000000011000001000000010001100000010010010010101
10000001000000000110100000001000010000011010000101001010001100000010010010010101
10010000000000000110000010001000010000011011000000010001001100000010010010010101
10000000000001000110000000000100000000011001000001010001001100000010010010010101
10000000100000000110001000000000010000011000000100010010001100000010010010010101
10000000000000000110000000001000000000011001101000001000001100000010010010010101
10000000000010000110011100000000001101111000000100100010001100000010010010010101
10000000000000000110000000010000100000011000001000000100001100000010010010010101
10010000000100000110001000001000010000011000000000100000001100000010010010010101
10000001000000000110100010000010000100011131111000000100001100000010010010010101
10000000000000000110000001000000001000011000000000000111111100000010010010010101
10000000000000000110000000000010100000011010001110001000001100000010010010010101
10000001000010000110001000010000001000011000000000000000001100000010010010010101
10000000000000000110010001000000001000011000001111111111111100000010010010010101
10000000000000000110000100001000011000011000000000001000001100000010010010010101
10000010000000000110000000100000000000011131000001000001001133333310010010010101
10000000000000000110000000000000000000011000111111111110001100000000000000000001
10000000000000000110001010000001000000011000000000000000011100000000000000000001
10000000000000000110010000010001000100011010001000000100001100000000000000000001
10000000000010000110010000001000010010011000100000100110001100000000000000000001
10010000000100000110100000001000000000011000001010000000001100000000000000000001
10000000000000000110000001000000000100011000100000010100101100000000000000000001
10000001000001000110000001000000100000011000010000000001001100000000000000000001
10000000000000000110000100000000000000011000010001000010001100000000000000000001
10000100000000000110000000010000001000011001000000100010001100000000000000000001
10000000000100000110000000000000000000011000100010000010001100000000000000000001
10000010000000000110010001000001001333311010000000010001001100000000000000000001
10000000000100000110000000000000000000011000010000001000001100333311111333333331
10000000010000000110000000000010010000011000100000000001001100000000000000000001
10100000000000000110000000000000000000011011000011100000001100000000000000000001
10000001000000000110100001000000000000111000000011111000001100000000000000000001
10010000000100000110100000000000000100011000001000010010001111111000000000000001
10000000000000000111000000010000000000011000010000001010101100003000000330033331
10000001000010000110000000000000000000011000101000010001001100333330000003300001
10000000000000000110100000000000000000011001000100000100001100000033301111000001
10000100000010000110000010000000010000011000001000001001001100333000330333000001
10000000001000000110000000000000000000011010000010000001001111111000333300033301
10000000000001000110000000000000000001011001000001000100001100333300000333000001
10000100000000000110001000010000000000011000100100000100001100033301110033300001
10000000100000000110000000000000100000011000011000001000001101111033300000000001
10000000001000000110000000000000000000011011000010010000001100033300033300111101
10100000000000000110000000000100000000011000100000001001001100003333330000000001
10000000001000000110000001000000000000011000000100000100001111103003331103000001
10000000000100000110000001000000000000011000100000100100001100000030000030000001
10010001000000000110000000000010000000011001001000000001001100000000111000330001
10000000100000000110000000000000000000011000001000100010001111110003000003300001
10000000000001000110000000000000000000011100010001000010001100030000300000000001
10000100100000000110000000000000000000011000100011000000001100003330033001111001
10000000000000000110000010001000000000011000000000000100001100003000000300000001
10000000000100000110000000000000001000011001000010001000001100000330000000000001
10000100000000000110000000000000000000011000100000101001001100000300033300000001
10000000010000000110000000001000000000011000001000100000001100003000000301111111
10000001000001000110010000000000000100011001000010100000001100000000000000000001
10001000000000000110000001000000000000011000100101000100001100033330030000300001
10000000000010000110000000000001000000011001000100001001001100000000000000000001
10000010000000000110001000000100000000011000100010000010001100030000000000300001
10000000000000000110000000000000000000011000000000100001001100000000000300000001
10000000000000000110000100000001000000011000010000100100001111000000000000000001
10000000000000000000000000000000000000011000011000000000002000C00000000000000001
11111111111111111111111111111111111111111111111111111111111111111111111111111111