NO ./img/sm64/1.png
WE ./img/sm64/2.png
SO ./img/sm64/3.png
EA ./img/sm64/4.png
F 0,0,0
C 0,200,200

1111                  11111
10S01                 10001
10001                 10101
10001                 10101
100011111             10101
100000001             10101
100000001             10101
100020001             10101
100000001             10101
100000001             10101
100011111             10101
100011111111111111111110101
100030000000000000000030301
100011111111111111111110101
10001                 10101
10001                 10101
10001                 10101
10001                 10101
100011111111111111111110101
100000000000000000000000101
100000000000000000000000101
111111111111111111111111121
                         1