NO ./img/4.png
WE ./img/mac.png
SO ./img/mac.png
EA ./img/mac.png
F 0,0,0
C 0,30,0

1111
10S01
10001
10001
10001
10001
10001
10001                 111
10001                 101
10001                 101
10001                 101
10001                 101
10001                 101
10001                 101
10001                 101
10001                 101
10001                 101
10001                 101
1000111111111111111111101
1000000000000000000000001
1000000000000000000000001
1111111111111111111111111
