NO ./img/sm64/1.png
WE ./img/sm64/2.png
SO ./img/sm64/3.png
EA ./img/sm64/4.png
MU ./audio/music/smrpg.mp3
F 0,0,0
C 0,200,200

111111111111111
1S0200000000001
100200000000001
100111111111001
100111111111001
100111111111001
100111111111001
1000000C0000001
1000000C0000001
111111111111111
