NO ./img/4.png
WE ./img/mac.png
SO ./img/mac.png
EA ./img/mac.png
F 0,0,0
C 0,30,0

1111
11011
10N01
1111