NO ./img/soviet/4.png
WE ./img/soviet/1.png
SO ./img/soviet/3.png
EA ./img/soviet/2.png
F 0,0,0
C 0,30,0

11111111111111111111
11000000000000000001
10000000000000000301
10000000000000000021
10000000000000000001
10000000000000000001
1N000000000000000001
11111111111111111111