NO ./img/4.png
WE ./img/mac.png
SO ./img/mac.png
EA ./img/mac.png
F 0,0,0
C 0,30,0

11111111111111111111
11000000000000000001
10000000000000000001
10000000000000000001
100000000N0000000001
10000000000000000001
10000000000000000001
11111111111111111111