NO ./img/sm64/4.png
WE ./img/sm64/1.png
SO ./img/sm64/3.png
EA ./img/sm64/2.png
F 0,0,0
C 0,30,0

11111111111111111111111111111
11000000000000000000000000001
10000000000000000000000000001
10000000000000000000000000001
10000000000000N00000000000001
10000000000000000000000000001
10000000000000000000000000001
11111111111111111111111111111